1111111111111
10C10000001C1
100011E000P01
1111111111111
