1111111111111111111111111111111111
1E00C000000C000C00000C00C00C000001
101001010010000010100100000C010101
101C01C01010101000100100C00C010111
1P00C0000C00C0000C00000CC00C0001C1
1111111111111111111111111111111111
