1111111111111
100100000CCC1
10EP011111CC1
1000111000001
1111111111111
