111111111111111111111111111111111111111111111111111111111111111111111111111111111111111111111111111111111111111111111111111111111111111111111111111111111111111111111111111111111111111111111111111111111111
1P0000000000000C00000C000000000000000000000000C00000C000000000000000000000000C00000C000000000000000000000000C00000C000000000000000000000000C00000C000000000000000000000000C00000C000000000000000000000000C01
1010010100100000101001000000010100000000000000C00000C000000000000000000000000C00000C000000000000000000000000C00000C000000000000000000000000C00000C000000000000000000000000C00000C000000000000000000000000C01
1010010010101010001001000000010100000000000000C00000C000000000000000000000000C00000C000000000000000000000000C00000C000000000000000000000000C00000C000000000000000000000000C00000C000000000000000000000000C01
100000E00C00C0000000000000000000C0000000000000C00000C000000000000000000000000C00000C000000000000000000000000C00000C000000000000000000000000C00000C000000000000000000000000C00000C000000000000000000000000C01
111111111111111111111111111111111111111111111111111111111111111111111111111111111111111111111111111111111111111111111111111111111111111111111111111111111111111111111111111111111111111111111111111111111111
