11111
10C01
10111
11C11
11111
